1 10 0,7 4
0 0 0 0 0 0 0 0 0 0 0 0 0 0 0
0 0 0 R G G G B G G G G R 0 0
0 0 0 B R 0 0 0 0 0 0 0 G 0 0
0 0 0 0 G 0 0 0 0 0 0 0 G 0 0
0 0 0 0 G 0 B B 0 0 0 0 B B 0
0 R G G B 0 B B G G G B 0 G 0
0 G 0 0 0 0 0 0 0 0 0 G 0 G 0
0 G 0 0 0 0 0 0 0 0 0 G 0 G 0
0 G 0 0 0 0 0 0 R G G B 0 G 0
0 G 0 0 0 0 0 0 R G G G G R 0
0 G 0 0 0 0 0 0 0 0 0 0 0 0 0
0 0 0 0 0 0 0 0 0 0 0 0 0 0 0