1 10 0,13 2
0 0 0 0 0 0 0 0 0 0 0 0 0 0 0
0 0 0 0 0 0 0 0 0 0 0 0 0 0 0
0 0 0 0 R G G G G G G G G G 0
0 0 0 0 G 0 0 0 0 0 0 0 0 0 0
0 0 0 0 G 0 0 0 0 0 0 0 0 0 0
0 R G G B 0 0 0 0 0 0 0 0 0 0
0 G 0 0 0 0 0 0 0 0 0 0 0 0 0
0 G 0 0 0 0 0 0 0 0 0 0 0 0 0
0 G 0 0 0 0 0 0 0 0 0 0 0 0 0
0 G 0 0 0 0 0 0 0 0 0 0 0 0 0
0 G 0 0 0 0 0 0 0 0 0 0 0 0 0
0 0 0 0 0 0 0 0 0 0 0 0 0 0 0