1 10 1,14 5
0 0 0 0 0 0 0 0 0 0 0 0 0 0 0
0 0 0 0 0 0 0 0 0 0 0 0 0 0 0
0 0 0 0 0 0 0 0 0 0 0 0 0 0 0
0 0 0 0 0 0 0 0 0 0 0 0 0 0 0
0 0 0 0 0 0 0 0 0 0 0 0 0 0 0
0 0 0 0 0 0 0 0 0 0 0 0 0 0 G
0 0 0 0 0 0 0 0 0 0 0 0 0 G G
0 0 0 0 0 0 0 0 0 0 0 0 G G 0
0 0 0 0 0 0 0 0 0 0 0 G G 0 0
0 0 0 0 0 0 0 0 0 0 G G 0 0 0
0 G G G G G G G G R G 0 0 0 0
0 0 0 0 0 0 0 0 0 0 0 0 0 0 0